######
#  #.#
# #. #
##.  #
#.   #
#BBBB#
#   &#
######
