    #######
    #     #
    #B    #
  ###     # 
  #  B  B #
### # ### #     ######
#   # ### #######  ..#
#    B              .#
##### #### #&####   .#
    #      ###  ######
    ########
